vaccination_site,uncategorized_count,total_count,categorized_count,uncategorized_percent,categorized_percent
SAMBÓDROMO,3146,8350,5204,37.67664670658682,62.32335329341318
HOSPITAL PORTUGUES,3138,6850,3712,45.81021897810219,54.18978102189781
UNIVERSIDADE PAULISTA / UNIP,2735,16945,14210,16.140454411330776,83.85954558866922
SESI CLUBE DO TRABALHADOR,2594,15485,12891,16.751695188892477,83.24830481110752
BALNEÁRIO DO SESC,2233,16709,14476,13.36405529953917,86.63594470046083
CENTRO CULTURAL DOS POVOS DA AMAZÔNIA,1977,12956,10979,15.259339302253782,84.74066069774622
DETRAN (PÁTIO),1838,12178,10340,15.09279027754968,84.90720972245032
SHOPPING PHELIPPE DAOU,1589,11372,9783,13.97291593387267,86.02708406612733
ESCOLA DE ENFERMAGEM DA UFAM,1279,3244,1965,39.42663378545006,60.57336621454994
HOSPITAL E PRONTO SOCORRO JOÃO LÚCIO PEREIRA MACHADO,145,571,426,25.39404553415061,74.6059544658494
HOSPITAL DHELPHINA AZIZ,113,725,612,15.586206896551724,84.41379310344827
HOSPITAL E P S DA CRIANÇA DA ZONA OESTE,100,189,89,52.910052910052904,47.08994708994709
HOSPITAL E PRONTO SOCORRO DR. ARISTOTELES PLATAO ARAUJO,85,422,337,20.14218009478673,79.85781990521326
HOSPITAL E PRONTO SOC. DA CRIANÇA DA ZONA LESTE / JOÃOZINHO,82,324,242,25.308641975308642,74.69135802469135
HOSPITAL PRONTO SOCORRO 28 DE AGOSTO,75,988,913,7.5910931174089065,92.4089068825911
HOSPITAL UNIVERSITARIO GETULIO VARGAS,74,621,547,11.916264090177133,88.08373590982286
HOSPITAL E PRONTO SOCORRO DA CRIANCA ZONA SUL,68,401,333,16.957605985037407,83.0423940149626
SPA ALVORADA,57,158,101,36.075949367088604,63.92405063291139
FUNDACAO DE MEDICINA TROPICAL,55,248,193,22.177419354838708,77.82258064516128
SPA COROADO,45,130,85,34.61538461538461,65.38461538461539
SPA SAO RAIMUNDO,40,151,111,26.490066225165563,73.50993377483444
SPA ELIAMEME MADY,38,99,61,38.38383838383838,61.61616161616161
UBS NEY LACERDA (RIO NEGRO) CNES 2016160,36,123,87,29.268292682926827,70.73170731707317
USF GEBES MEDEIROS,33,67,34,49.25373134328358,50.74626865671642
UPA JOSE RODRIGUES,33,128,95,25.78125,74.21875
UBS ANTÔNIO LEVINO (RIO AMAZONAS) CNES 9518924,29,110,81,26.36363636363636,73.63636363636363
USF LEONOR DE FREITAS,28,138,110,20.28985507246377,79.71014492753623
USF MJ PM SÁLVIO BELOTA,27,97,70,27.835051546391753,72.16494845360825
USF ALFREDO CAMPOS,24,75,51,32.0,68.0
SPA ZONA SUL,24,118,94,20.33898305084746,79.66101694915254
SPA E POLICLINICA DR JOSE LINS,23,121,98,19.00826446280992,80.99173553719008
UBS MORRO DA LIBERDADE,22,68,46,32.35294117647059,67.64705882352942
USF ARTHUR VIRGILIO,21,52,31,40.38461538461539,59.61538461538461
UBS THEODOMIRRO GARRIDO,19,44,25,43.18181818181818,56.81818181818182
UBS NOSSA SRA DO LIVRAMENTO CNES 20161117,19,74,55,25.675675675675674,74.32432432432432
UBS NOSSA SRA DE FÁTIMA CNES 2016109,19,125,106,15.2,84.8
UBS PAU ROSA CNES 3809757,17,159,142,10.69182389937107,89.30817610062893
USF IVONE LIMA,17,41,24,41.46341463414634,58.536585365853654
USF SANTOS DUMONT,17,55,38,30.909090909090907,69.0909090909091
UBS DR. LUIZ MONTENEGRO,16,49,33,32.6530612244898,67.3469387755102
SPA JOVENTINA DIAS,16,142,126,11.267605633802818,88.73239436619718
SPA DANILO CORREA,15,109,94,13.761467889908257,86.23853211009175
UBS SÃO PEDRO CNES 3808807,15,72,57,20.833333333333336,79.16666666666666
EM DOMICÍLIO,14,1270,1256,1.1023622047244095,98.8976377952756
FUNDACAO CECON,14,107,93,13.084112149532709,86.91588785046729
USF DR. AUGIAS GADELHA,14,66,52,21.21212121212121,78.78787878787878
USF DEODATO DE M. LEÃO,14,36,22,38.88888888888889,61.111111111111114
HOSPITAL SANTA JULIA,14,402,388,3.482587064676617,96.51741293532339
UBS EFIGÊNIO SALES CNES 6355226,13,79,66,16.455696202531644,83.54430379746836
USF BALBINA MESTRINHO,13,65,52,20.0,80.0
MATERNIDADE ANA BRAGA,13,173,160,7.514450867052023,92.48554913294798
UBS THEOMÁRIO PINTO DA COSTA,12,44,32,27.27272727272727,72.72727272727273
UBS NOSSA SRA AUXILIADORA CNES 2016079,12,70,58,17.142857142857142,82.85714285714286
CHECKUP HOSPITAL LTDA,10,132,122,7.575757575757576,92.42424242424242
UBS JOSÉ RAYOL DOS SANTOS,9,49,40,18.367346938775512,81.63265306122449
HOSPITAL DE AERONAUTICA DE MANAUS,9,89,80,10.112359550561797,89.8876404494382
INSTITUTO DA MULHER DONA LINDU,9,93,84,9.67741935483871,90.32258064516128
UBS ADA VIANA CNES 3809706,8,76,68,10.526315789473683,89.47368421052632
USF AMAZONAS PALHANO,8,40,32,20.0,80.0
HOSPITAL E MATERNIDADE CHAPOT PREVOST,7,60,53,11.666666666666666,88.33333333333333
UPA 24HS CAMPOS SALES,7,56,49,12.5,87.5
USF CF CARMEN NICOLAU,7,47,40,14.893617021276595,85.1063829787234
UBS NILTON LINS,6,84,78,7.142857142857142,92.85714285714286
USF LEONOR BRILHANTE,6,41,35,14.634146341463413,85.36585365853658
USF CF CARLSON GRACIE,5,25,20,20.0,80.0
USF VICENTE PALLOTTI,4,17,13,23.52941176470588,76.47058823529412
WF CONTROL,4,111,107,3.6036036036036037,96.3963963963964
HOSPITAL FRANCISCA MENDES,3,96,93,3.125,96.875
CENTRAL DE REGULAÇÃO SAMU 192 REGIONAL MANAUS,3,266,263,1.1278195488721803,98.87218045112782
HOSPITAL GERAL DE MANAUS,3,118,115,2.5423728813559325,97.45762711864407
SAMEL - BOULEVARD ÁLVARO MAIA,2,64,62,3.125,96.875
MATERNIDADE NAZIRA DAOU,2,71,69,2.8169014084507045,97.1830985915493
ESCOLA MUNICIPAL MADRE TERESA DE CALCUTÁ,1,10,9,10.0,90.0
CONSELHO COMUNITÁRIO DO SÃO JOSE II,1,7,6,14.285714285714285,85.71428571428571
CRECHE NOSSA SENHORA DO CARMO,1,10,9,10.0,90.0
DCODCC-CONSELHO DO,1,10,9,10.0,90.0
ESCOLA CENTRO EDUCACIONAL POSITIVIANO,1,12,11,8.333333333333332,91.66666666666666
UBS LUCIO FLAVIO DE VASCONCELOS DIAS,1,9,8,11.11111111111111,88.88888888888889
HOSPITAL ADVENTISTA DE MANAUS,1,381,380,0.26246719160104987,99.73753280839895
SAMEL - JOAQUIM NABUCO,1,54,53,1.8518518518518516,98.14814814814815
MATERNIDADE AZILDA MARREIRO,1,29,28,3.4482758620689653,96.55172413793103
MORHAN-MOVIMENTO DE REINT DAS PESSOAS ATINGIDAS PELA HANSENIASE,1,11,10,9.090909090909092,90.9090909090909
PROJETO SOCIAL LAR DA MARIAZINHA,1,8,7,12.5,87.5
A ESCOLA MUNICIPAL,1,9,8,11.11111111111111,88.88888888888889
