vaccination_site,uncategorized_count,total_count,categorized_count,uncategorized_percent,categorized_percent
SAMBÓDROMO,3173,8448,5275,37.55918560606061,62.44081439393939
HOSPITAL PORTUGUES,3143,6864,3721,45.78962703962704,54.210372960372965
UNIVERSIDADE PAULISTA / UNIP,2736,16949,14213,16.142545282907548,83.85745471709245
SESI CLUBE DO TRABALHADOR,2667,15699,13032,16.988343206573667,83.01165679342634
BALNEÁRIO DO SESC,2256,16887,14631,13.359388879019363,86.64061112098064
CENTRO CULTURAL DOS POVOS DA AMAZÔNIA,2040,13199,11159,15.455716342147133,84.54428365785287
DETRAN (PÁTIO),1872,12312,10440,15.204678362573098,84.7953216374269
SHOPPING PHELIPPE DAOU,1589,11372,9783,13.97291593387267,86.02708406612733
ESCOLA DE ENFERMAGEM DA UFAM,1313,3340,2027,39.311377245508986,60.688622754491014
HOSPITAL E PRONTO SOCORRO JOÃO LÚCIO PEREIRA MACHADO,145,571,426,25.39404553415061,74.6059544658494
HOSPITAL DHELPHINA AZIZ,113,725,612,15.586206896551724,84.41379310344827
HOSPITAL E P S DA CRIANÇA DA ZONA OESTE,100,189,89,52.910052910052904,47.08994708994709
HOSPITAL E PRONTO SOCORRO DR. ARISTOTELES PLATAO ARAUJO,85,422,337,20.14218009478673,79.85781990521326
HOSPITAL E PRONTO SOC. DA CRIANÇA DA ZONA LESTE / JOÃOZINHO,82,324,242,25.308641975308642,74.69135802469135
HOSPITAL PRONTO SOCORRO 28 DE AGOSTO,75,988,913,7.5910931174089065,92.4089068825911
HOSPITAL UNIVERSITARIO GETULIO VARGAS,74,621,547,11.916264090177133,88.08373590982286
HOSPITAL E PRONTO SOCORRO DA CRIANCA ZONA SUL,68,401,333,16.957605985037407,83.0423940149626
SPA ALVORADA,57,158,101,36.075949367088604,63.92405063291139
FUNDACAO DE MEDICINA TROPICAL,55,248,193,22.177419354838708,77.82258064516128
SPA COROADO,45,130,85,34.61538461538461,65.38461538461539
SPA SAO RAIMUNDO,40,151,111,26.490066225165563,73.50993377483444
SPA ELIAMEME MADY,38,99,61,38.38383838383838,61.61616161616161
UBS NEY LACERDA (RIO NEGRO) CNES 2016160,36,124,88,29.03225806451613,70.96774193548387
UBS ANTÔNIO LEVINO (RIO AMAZONAS) CNES 9518924,35,118,83,29.66101694915254,70.33898305084746
USF GEBES MEDEIROS,33,67,34,49.25373134328358,50.74626865671642
UPA JOSE RODRIGUES,33,128,95,25.78125,74.21875
USF LEONOR DE FREITAS,28,138,110,20.28985507246377,79.71014492753623
USF MJ PM SÁLVIO BELOTA,27,97,70,27.835051546391753,72.16494845360825
SPA ZONA SUL,24,118,94,20.33898305084746,79.66101694915254
USF ALFREDO CAMPOS,24,75,51,32.0,68.0
SPA E POLICLINICA DR JOSE LINS,23,121,98,19.00826446280992,80.99173553719008
UBS MORRO DA LIBERDADE,22,68,46,32.35294117647059,67.64705882352942
USF ARTHUR VIRGILIO,21,52,31,40.38461538461539,59.61538461538461
EM DOMICÍLIO,20,1332,1312,1.5015015015015014,98.49849849849849
UBS THEODOMIRRO GARRIDO,19,44,25,43.18181818181818,56.81818181818182
UBS NOSSA SRA DE FÁTIMA CNES 2016109,19,125,106,15.2,84.8
UBS NOSSA SRA DO LIVRAMENTO CNES 20161117,19,75,56,25.333333333333336,74.66666666666667
UBS PAU ROSA CNES 3809757,18,162,144,11.11111111111111,88.88888888888889
USF SANTOS DUMONT,17,55,38,30.909090909090907,69.0909090909091
USF IVONE LIMA,17,41,24,41.46341463414634,58.536585365853654
SPA JOVENTINA DIAS,16,142,126,11.267605633802818,88.73239436619718
UBS DR. LUIZ MONTENEGRO,16,49,33,32.6530612244898,67.3469387755102
UBS SÃO PEDRO CNES 3808807,15,72,57,20.833333333333336,79.16666666666666
SPA DANILO CORREA,15,109,94,13.761467889908257,86.23853211009175
USF DR. AUGIAS GADELHA,14,66,52,21.21212121212121,78.78787878787878
HOSPITAL SANTA JULIA,14,402,388,3.482587064676617,96.51741293532339
USF DEODATO DE M. LEÃO,14,36,22,38.88888888888889,61.111111111111114
FUNDACAO CECON,14,107,93,13.084112149532709,86.91588785046729
UBS EFIGÊNIO SALES CNES 6355226,13,79,66,16.455696202531644,83.54430379746836
MATERNIDADE ANA BRAGA,13,173,160,7.514450867052023,92.48554913294798
USF BALBINA MESTRINHO,13,65,52,20.0,80.0
UBS THEOMÁRIO PINTO DA COSTA,12,44,32,27.27272727272727,72.72727272727273
UBS NOSSA SRA AUXILIADORA CNES 2016079,12,72,60,16.666666666666664,83.33333333333334
CHECKUP HOSPITAL LTDA,10,132,122,7.575757575757576,92.42424242424242
HOSPITAL DE AERONAUTICA DE MANAUS,9,89,80,10.112359550561797,89.8876404494382
UBS JOSÉ RAYOL DOS SANTOS,9,49,40,18.367346938775512,81.63265306122449
INSTITUTO DA MULHER DONA LINDU,9,93,84,9.67741935483871,90.32258064516128
UBS ADA VIANA CNES 3809706,8,76,68,10.526315789473683,89.47368421052632
USF AMAZONAS PALHANO,8,40,32,20.0,80.0
HOSPITAL E MATERNIDADE CHAPOT PREVOST,7,60,53,11.666666666666666,88.33333333333333
USF CF CARMEN NICOLAU,7,47,40,14.893617021276595,85.1063829787234
UPA 24HS CAMPOS SALES,7,56,49,12.5,87.5
USF LEONOR BRILHANTE,6,41,35,14.634146341463413,85.36585365853658
UBS NILTON LINS,6,84,78,7.142857142857142,92.85714285714286
USF O 46,5,7,2,71.42857142857143,28.57142857142857
USF CF CARLSON GRACIE,5,25,20,20.0,80.0
USF VICENTE PALLOTTI,4,17,13,23.52941176470588,76.47058823529412
WF CONTROL,4,111,107,3.6036036036036037,96.3963963963964
HOSPITAL GERAL DE MANAUS,3,118,115,2.5423728813559325,97.45762711864407
CENTRAL DE REGULAÇÃO SAMU 192 REGIONAL MANAUS,3,266,263,1.1278195488721803,98.87218045112782
HOSPITAL FRANCISCA MENDES,3,96,93,3.125,96.875
SAMEL - BOULEVARD ÁLVARO MAIA,2,64,62,3.125,96.875
CENTRO DE CONVIVÊNCIA PADRE PEDRO VIGNOLA,2,3,1,66.66666666666666,33.33333333333333
CRECHE NOSSA SENHORA DO CARMO,2,20,18,10.0,90.0
MATERNIDADE NAZIRA DAOU,2,71,69,2.8169014084507045,97.1830985915493
ESCOLA CENTRO EDUCACIONAL POSITIVIANO,2,38,36,5.263157894736842,94.73684210526315
ESCOLA MUNICIPAL ELVIRA BORGES,2,48,46,4.166666666666666,95.83333333333334
ESCOLA MUNICIPAL ERIC VICENTE,2,21,19,9.523809523809524,90.47619047619048
HOSPITAL ADVENTISTA DE MANAUS,1,381,380,0.26246719160104987,99.73753280839895
CONSELHO COMUNITÁRIO DO SÃO JOSE II,1,17,16,5.88235294117647,94.11764705882352
DCODCC-CONSELHO DO,1,17,16,5.88235294117647,94.11764705882352
UBS LUCIO FLAVIO DE VASCONCELOS DIAS,1,9,8,11.11111111111111,88.88888888888889
SAMEL - JOAQUIM NABUCO,1,54,53,1.8518518518518516,98.14814814814815
IGREJA BATISTA SHALOM,1,16,15,6.25,93.75
IGREJA CATÓLICA SÃO JOSE OPERÁRIO,1,19,18,5.263157894736842,94.73684210526315
MATERNIDADE AZILDA MARREIRO,1,29,28,3.4482758620689653,96.55172413793103
MINI VILA OLIMPICA JAIR SAMPAIO,1,29,28,3.4482758620689653,96.55172413793103
N MIAOSREHAN-MOVIMENTO DE,1,40,39,2.5,97.5
PROJETO SOCIAL LAR DA MARIAZINHA,1,8,7,12.5,87.5
REINT DAS PESSOAS ATINGIDAS PELA HANSENIASE,1,9,8,11.11111111111111,88.88888888888889
A ESCOLA MUNICIPAL,1,20,19,5.0,95.0
